############
#      #   #
# ##  ## # #
# #  #G  # #
#     ###  #
# #### #   #
# #    #   #
# # # ##   #
#   #      #
############
